tras	after	p
la	the	a
caída	fall	v
del	of	p
Imperio	Empire	n
romano	Roman	adj
en	in	p
siglo	century	n
V	V	num
influencia	influence	n
latín	Latin	n
culto	cult	n
gente	people	n
común	common	adj
fue	was	v
disminuyendo	decreasing	v
paulatinamente	gradually	adv
hablado	spoken	v
entonces	then	adv
fermento	ferment	v
variedades	varieties	n
romances	romances	n
hispánicas	Hispanic	adj
origen	origin	n
española	Spanish	adj
VIII	VIII	num
invasión	invasion	n
musulmana	Muslim	adj
Península	peninsula	n
Ibérica	Iberian	adj
hace	ago	adv
se	is	v
formen	form	n
dos	two	num
zonas	areas	n
bien	well	adj
diferenciadas	differentiated	adj
el	the	a
idioma	language	n
español	spanish	n
o	or	conj
castellano	castilian	adj
es	is	v
una	a	a
lengua	language	n
romance	romance	adj
grupo	group	n
ibérico		Iberian	adj
uno	one	num
de	of	p
los	the	a
seis	six	num
idiomas	languages	n
oficiales	official	adj
ONU	UN	n
segunda	second	num
más	more	adv
hablada	spoken	v
mundo	world	n
número	number	n
tienen	have	v
como as	adv
materna	maternal	adj
chino	chinese	adj
mandarín	mandarin n
también also	adv
oficial	official	adj
varias	more	adj
las	the	a
principales	main adj 
organizaciones	organizations	n
político-económicas	political-economic	adj
internacionales	international	adj
lo	it	pro
hablan	speak	v
primera	first	num
y	and	conj
más	more	adv
450	450	num
millones	million	num
supera	than	prep
500	500	num
personas	people	noun
si	if	conj
contamos	we	pro
a	to	p
que	that	det
han	have	v
aprendido	learned	v
extranjera	foreign	adj
pudiendo	can	v
ser	be	v
tercera	third	num
hablada	spoken	v
por	by	p
total	total	adj
hablantes	speakers	n
otras	others	n
continuación continuation	n
moderna	modern	adj
latín latin	adj
hablado	spoken	v
desde	from	p
III	III	num
historia	history	n
comienza	begins	v
vulgar	vulgar	adj
concretamente	specifically	adj
zona	area	n
central	central	adj
hispania	hispania n
con	with	p
norte	north	n
lenguas	languages	n